{
    "background_color": [
        30,
        30,
        50
    ],
    "tile_size": 32,
    "player_spawn": [
        0,
        0
    ],
    "tilemap": {
        "legend": {
            "P": {"type": "platform"},
            "·": null 
        },
        "data": [
            "·····················································",
            "·····················································",
            "·····················································",
            "·····················································",
            "·····················································",
            "·····················································",
            "·····················································",
            "·····················································",
            "·····················································",
            "······················PPPP···························",
            "·····················································",
            "·····················································",
            "·····················································",
            "············PPP······PPPP······PPP·········PPPP········",
            "········································PP···········",
            "·········PP···············PP·························",
            "··················PPP···············PPP··············",
            "·····················································",
            "·····················································",
            "·················PP··································",
            "·····················································",
            "··············PP·····································",
            "··········PP·······························PPPPPPPPPP",
            "PPPPPPPPPPPPPPPPPPPPPPPPPPPPP·························",
            "PPPPPPPPPPPPPPPPPPPPPPPPPPPPPPPPPPPPPPPPPPPPPPPPPPPPPP" 
        ]
    }
}