{
    "background_color": [
        30,
        30,
        50
    ],
    "tile_size": 32,
    "player_spawn": [
        100,
        300
    ],
    "tilemap": {
        "legend": {
            "P": {"type": "platform"},
            "·": null 
        },
        "data": [
            "·····················································",
            "·····················································",
            "·····················································",
            "·····················································",
            "·····················································",
            "·····················································",
            "·····················································",
            "·····················································",
            "·····················································",
            "······················PPPP···························",
            "·····················································",
            "·····················································",
            "·····················································",
            "············PPP···············PPP····················",
            "·····················································",
            "·····················································",
            "··················PPP···············PPP··············",
            "·····················································",
            "·····················································",
            "·················PP··································",
            "·····················································",
            "··············PP·····································",
            "··········PP·········································",
            "·····················································",
            "PPPPPPPPPPPPPPPPPPPPPPPPPPPPP···········" 
        ]
    }
}